stitch	V	nähen, vernähen, steppen, heften
stitch	N	stich, masche, stichart, seitenstiche
pedophile	N	pädophile
unworldly	A	weltabgewandt, weltfremd
nominal	A	nominal, nominell, symbolisch, substantivisch, nominal-
insecure	A	unsicher, haltlos
inaction	N	untätigkeit, tatenlosigkeit
movability	N	beweglichkeit, transportfähigkeit
uncover	V	aufdecken, entlarven, entschleiern, entblößen, bloßlegen, enthüllen, bringen: zum vorscheit bringen, freilegen
jaywalk	V	unvorsichtig über die straße gehen
romany	N	zigeunersprache, zigeuner, roma
carnival	A	fest-, karnevals-
carnival	N	fasching, karneval, fest, volksfest, schützenfest
waiter	N	kellner, ober
contented	A	befriedigt, behaglich, stillvergnügt, zufrieden
jolliness	N	lustigkeit
maharajah	N	maharadscha
funky	A	feige, ängstlich, irre
registrar	N	kurator, registrator, standesbeamte
invalidity	N	ungültigkeit, nichtigkeit, hinfälligkeit, kraftlosigkeit
assuredly	ADV	gewiss: ganz gewiss, sicherheit: mit sicherheit
remorseful	A	reuig, reumütig, zerknirscht, zerknittert
first	A	erste, ursprünglich
first	ADV	zuerst, als erste, erst, zunächst, erstens, linie: in erster linie, erst: zum ersten mal, vorneweg, voran
efface	V	auslöschen, ausstreichen, verwischen
nutritional	A	ernährungs-, nähr-
well-wisher	N	gratulant
morose	A	verdrießlich, verdrossen, übelgelaunt, grämlich, griesgrämig, mürrisch, missmutig, verstockt
intrastate	A	innerhalb der bundesstaaten, innerhalb der staaten
methodological	A	methodologisch
unassumingness	N	bescheidenheit
lambaste	V	fertig machen, tüchtig: es tüchtig geben
fiery	A	feurig, glühend, flammend, scharf, hitzig, rassig
speaking	A	sprechend, mama-, verblüffend
speaking	N	sprechen, reden
bantering	A	neckisch, scherzhaft
gaudy	A	knallig, grell, geschmacklos, scheckig, schreiend
inefficient	A	unfähig, leistungsfähig: nicht leistungsfähig, untüchtig, ineffektiv, ineffizient, inkompetent, unproduktiv, unrationell
allegedly	ADV	angeblich
streaked	A	gestreift
memo	N	mitteilung, notiz, zettel, memo
crevice	N	felsspalte, ritze, spalte, riss, spalt
occident	N	okzident, abendland, westen
blackguard	N	schuft, schurke
calumny	N	verleumdung, schmähung, verunglimpfung
deafen	V	taub machen
doddering	A	tatterig
illegality	N	ungesetzlichkeit, gesetzwidrigkeit, rechtswidrigkeit, illegalität
easement	N	erleichterung, erlösung, linderung, befreiung, hilfe, grunddienstbarkeit
centigrade	A	hundertteilig
centigrade	N	celsius, grad celsius
proofread	V	korrektur lesen
precociousness	N	frühreife
lick	V	lecken, belecken, züngeln, schlecken, bügeln
lick	N	lecken, schlecken, salzlecke, lecke, leckstein
capsize	V	kentern, bringen: zum kentern bringen
naze	N	nase
incontestable	A	unbestreitbar, unanfechtbar
narrator	N	erzähler, sprecher
pastry	N	teig, konditorware, torten, pasteten
nazi	A	nazi-
nazi	N	nazi, faschist
modality	N	modalität
cassandra	N	kassandra
squaw	N	squaw
squat	A	kompakt, gedrungen, niedrig, hocken, kauern
squat	N	hocke, unterschlupf
bailee	N	verwahrer
foreigner	N	ausländer, fremde
acumen	N	scharfsinn
squab	N	jungtaube, bank
bodiless	A	körperlos
canna	N	canna [bot.]
blockade-runner	N	blockadebrecher
arguing	N	streiterei
whizz	V	schwirren, sausen, zischen, flitzen, wutschen
whizz	N	schwirren, sausen, kanone
rehearsal	N	einübung, aufzählung, probe
beta	N	beta
barrage	N	kanonade, talsperre, staudamm, sperrfeuer
billow	V	wogen, bauschen, aufbauschen: sich aufbauschen, blähen: sich blähen
billow	N	woge, bauschen, blähen, schwaden
canny	A	sparsam, umsichtig, vorsichtig, schlau
upland	A	hochland-
upland	N	hochland
radioactive	A	radioaktiv, strahlend
incisive	A	prägnant, scharf, treffend, scharfsinnig
participial	A	partizipial, partizipial-
participial	ADV	partizip: in der art eines partizips
participle	N	partizip
deportment	N	körperhaltung, benehmen
scowl	V	blicken: finster blicken, gesicht: finsteres gesicht machen, gesicht: böses gesicht machen
scowl	N	blick: finsterer blick, ausdruck: unmutiger ausdruck, gesicht: böses gesicht
voodoo	N	voodoo, wodu
toucan	N	tukan
iniquitous	A	mörderisch, ungeheuerlich, sündhaft
rejoinder	N	erwiderung
big-boned	A	grobknochig
cravat	N	halstuch
supposition	N	mutmaßung, spekulation, annahme, vermutung
bedside	N	bettseite
tiredness	N	müdigkeit, ermüdung, erschlaffung, überdruss
disunite	V	spalten, entzweien
threshold	N	schwelle, türschwelle, beginn, eingang
enthusiast	N	enthusiast, liebhaberin, liebhaber, anhänger, schwärmer
amateurish	A	amateurhaft, dilettantisch, laienhaft, stümperhaft
stormy	A	stürmisch, hitzig, heftig
frankish	A	fränkisch
frankish	N	fränkisch
treasure	V	schätzen, hüten
treasure	N	schatz, reichtum, kostbarkeit, hort, herrlichkeit
spirituality	N	geistigkeit
helix	N	spirale, wendel
travesty	V	travestieren
travesty	N	travestie, zerrbild
admixture	N	beimischung, zusatz
moldy	A	verschimmelt, schimmelig, stockfleckig, stockig, miserabel, lumpig, dumpfig, schäbig
friary	N	mönchkloster
sanguinary	A	blutig, blutrünstig, derb
dishonourable	A	ehrlos, unehrenhaft
bittern	N	rohrdommel
blende	N	blende
stomp	V	stapfen
geocentric	A	geozentrisch
tippet	N	krawatte, schultertuch, stola
bibliophile	N	bibliophile, büchernarr
unimportant	A	unwichtig, unbedeutend, bedeutungslos, gleichgültig, unerheblich, unwesentlich
unconsciously	ADV	unbewusst
chiropractor	N	chiropraktiker
bitters	N	bitter, magenbitter
stoma	N	stoma
neckerchief	N	halstuch
hyphenate	V	koppeln, bindestrich: mit bindestrich schreiben
gem	N	edelstein, juwel, schmuckstück, perle, kleinod, leckerbissen
gel	V	gelieren, fest werden, gestalt annehmen
gel	N	gel
illiberal	A	engstirnig, intolerant, engherzig, illiberal, knauserig, geizig
seared	A	verwelkt
skull	N	schädel, totenkopf
pitcher	N	krug, werfer
colossus	N	gigant, hüne, koloss, riese
malaysian	A	malaysisch
malaysian	N	malaysier, malaysierin
morning	A	morgendlich, morgen-, vormittags-, früh-
morning	ADV	früh
miler	N	1500-meter-läufer
undertone	N	unterton
nostril	N	nasenloch, nüster, flügel
gammon	N	schinken
tallow	N	talg, unschlitt
declared	A	erklärt
sear	V	brennen, verbrennen, durchzucken, ausbrennen, anbraten, anbraten: rasch anbraten, zutiefst treffen, ausdörren, austrocknen
starlet	N	sternchen, filmsternchen, starlet
checkered	A	kariert, kunterbunt, schachbrettartig
psychosis	N	psychose
seam	V	nähen, durchziehen, anmuten
seam	N	naht, narbe, fuge, flöz, saum, ader
seal	V	versiegeln, besiegeln, siegeln, zukleben, zumauern, dichten, plombieren, zumachen, verschließen
seal	N	seehund, siegel, versiegelung, stempel, ring, siegelring, plombierung, plombe, aufkleber, dichtung, abdichtung, verschluss
unaltered	A	unverändert
adjudge	V	zuerkennen, erachten für
insoluble	A	unlöslich, unlösbar
insoluble	ADV	unauflöslich
sincere	A	aufrichtig, offen, ehrlich, ernst, ernsthaft, herzlich, echt
impetigo	N	eiterflechte, impetigo
satisfying	A	befriedigend, sättigend
satisfying	N	befriedigung
tongue-tied	A	sprachlos, stumm
atomistic	A	atomistisch
enough	A	genug, genügend, ausreichend
enough	ADV	genug, genügend, genügsam
across	ADV	herüber, hinüber, durch, breit, waagerecht
across	PREP	durch, über
satiate	V	stillen, sättigen, übersättigen
august	N	august
slumbrous	A	schläfrig, einschläfernd, einlullend
nationality	N	staatsangehörigkeit, nationalität
gauntlet	N	panzerhandschuh, stulpenhandschuh, stulpe
vaporous	A	gasförmig, dampfförmig, nebulös, verblasen
astrologer	N	astrologe, sterndeuter
fulminate	V	wettern, donnern
restroom	N	bedürfnisanstalt, toilette
sketchy	A	flüchtig, oberflächlich, dürftig, bruchstückhaft, skizzenhaft, lückenhaft
concentrate	A	konzentriert
concentrate	N	konzentrat
tout	V	ausspionieren, herumschnüffeln, anbieten, schwarz verkaufen
tout	N	wettberater, schnüffler, spion, kartenschwarzhändler, schwarzhändler, kundenfänger, schlepper
cognizance	N	erkenntnis, erkenntnisnahme
millpond	N	mühlteich
nonentity	N	nullität, figur: unbedeutende figur, nichts, null
bloodiness	N	blutigkeit, grässlichkeit, abscheulichkeit
about-face	V	kehrtmachen
about-face	N	wendung, kehrtwendung, schwenk, umschwung
hospice	N	hospiz, pflegeheim
uncouple	V	abkuppeln, abkoppeln, abhängen
pacifier	N	friedensstifter, schnuller, nuckel, sauger
elbow	V	rempeln
elbow	N	ellbogen, knie
tercet	N	terzine
tramp	V	stampfen, trampeln, trampen, marschieren, wandern
tramp	N	landstreicher, tramp, getrampel, stadtstreicher, pennbruder, stapfen, schritt: schwere schritte, wanderung, trampfdampfer
wobble	V	kippeln, wackeln, schwanken, zittern, wabbeln, quabbeln, eiern, schwabbeln, flattern, lottern, wanken, rütteln an, ruckeln an, wackeln an
wobble	N	wackeln
repine	V	hadern
crossfire	N	kreuzfeuer
lisle	N	baumwollfaden, florgarn
wobbly	A	wackelig, wacklig, kippelig, zitterig, zitternd, quabbelig, schwabbelig, wabbelig, eiernd
judging	N	wertung
fleetingness	N	flüchtigkeit
capably	ADV	kompetent, geschickt
fiftieth	A	fünfzigste
fiftieth	NUM	fünfzigste
derogation	N	beeinträchtigung, schmälerung, abbruch
lustily	ADV	kräftig, schwung: mit schwung und energie, herzhaft, kehle: aus voller kehle, hals: aus vollem halse, hals: aus vollem hals
disconcertment	N	befremden
squash	V	zerdrücken, verdrücken, zerquetschen, zerdrücken: zerdrückt werden, quetschen, zerquetschen: zerquetscht werden, quetschen: sich quetschen
squash	N	fruchtsaft, fruchtsaftkonzentrat, menschenmenge, menge, gedränge, squash, kürbis
atomization	N	atomisierung, zerstäubung
roguish	A	spitzbübisch, bübisch, schalkhaft, schurkisch
sound	A	gesund, kräftig, einwandfrei, reell, solide, vernünftig, fundiert, gründlich, verlässlich, stabil, wertvoll, klug, treffsicher, gehörig, vernichtend, rechtmäßig, berechtigt, tief, fest
sound	N	beiklang, geräusch, laut, schall, klang, ton, sund, meerenge
epidermis	N	epidermis, oberhaut
cannonade	N	kanonade
ratchet	N	ratsche, klinke, sperrklinke, sperrstange
coca	N	koka
forefinger	N	zeigefinger
coco	N	kokospalme
stepfather	N	stiefvater
cock	V	spannen, spitzen
cock	N	hahn, wetterhahn, männchen, kolben, riemen, schwanz, rute, flöte
ulysses	N	odysseus, ulixes, ulysses
strait	N	meerenge, enge, straße
sleeping	A	schlafend, still
unwritten	A	ungeschrieben, stillschweigend
unsporting	A	unsportlich, unfair
synagogue	N	synagoge
doubting	A	ungläubig
paring	N	beschneidung
lave	V	fließen, schöpfen, waschen
creaky	A	knarrend, quietschend, knackend
woodland	N	wald, waldland, waldfläche
belie	V	enttäuschen, verleumden, widersprechen, widerlegen
lava	N	lava
compiling	N	zusammenstellung
princedom	N	fürstentum
aerobics	N	aerobic
clammy	A	feuchtkalt, klamm
safe-conduct	N	geleit: freies geleit, geleit: sicheres geleit, geleitbrief
essayist	N	essayist
patrician	A	patrizisch
assist	V	helfen, assistieren, bedienen, beistehen, fördern
incarceration	N	einkerkerung, kerkerhaft
decompress	V	dekomprimieren
enquirer	N	fragende
flipper	N	flosse, schwimmflosse
adjure	V	beschwören
polygon	N	vieleck
tom-tom	N	tamtam
businesslike	A	dienstlich, geschäftlich, geschäftsmäßig, sachlich, kühl, nüchtern
intercostal	A	zwischenliegend
calumniate	V	verleumden, schmähen, verunglimpfen
stunted	A	verkümmert, verwachsen, krüppelig
soundproof	A	schalldicht
soundproof	V	schalldämmen, schalldicht machen
sandiness	N	sandigkeit
uncomplicated	A	unkompliziert, einfach, unproblematisch
alfalfa	N	luzerne, alfalfa
yearly	A	jährlich
yearly	ADV	jährlich, jahr: einmal im jahr
pastern	N	fessel
unofficial	A	inoffiziell, amtlich: nicht amtlich, wild
griddle	N	bratpfanne
diagrammatic	A	grafisch
leeway	N	abdrift, leeweg, zeitverlust, spielraum
thudding	N	gebumse, gepolter
flavor	V	würzen, geschmack verleihen, geschmack geben
flavor	N	geschmack, wohlgeschmack, aroma, beigeschmack, touch
willy-nilly	ADV	nolens volens
clueless	A	ahnungslos, hilflos, unbedarft, ratlos
meteorite	N	meteorit
pitman	N	kumpel
decentralization	N	dezentralisierung
glutinous	A	klebrig, leimig, zäh, seimig
zulu	A	zulu-, zulu: der zulu
zulu	N	zulu
zephyr	N	zephir, zephyr
gnarled	A	astig, knorrig, knotig
credentials	N	referenzen, akkreditiv, voraussetzungen, zeugnisse, beglaubigungsschreiben
moreover	ADV	überdies, zudem, außerdem
indecipherable	A	entziffern: nicht zu entziffern sein, unkenntlich
vending	A	verkaufs-
glume	N	spelze
fanlight	N	fensterklappe
marmoset	N	krallenaffe, pinseläffchen
demography	N	demographie
passionate	A	leidenschaftlich, heftig, stürmisch, heiß, hitzig, passioniert
casuistic	A	kasuistisch
afflict	V	plagen, belasten, heimsuchen, prüfen
pronounce	V	aussprechen, fällen, sprechen, behaupten, verkünden, erklären
showman	N	schausteller, showman, meister
weightiness	N	gewichtigkeit
nazism	N	nazismus
snoring	N	schnarchen
genetics	N	genetik
calculating	A	berechnend
drenched	A	klitschnass, platschnass
lotto	N	lotto
u-turn	N	wende
gladden	V	erfreuen
decagram	N	dekagramm
husbandman	N	ackerbauer, bauer, landmann, landwirt
dispensary	N	krankenhausapotheke, ausapothekenabteilung, dispensarium
raincoat	N	regenmantel
dray	N	pferdewagen, fuhrwerk, fuhre
each	A	jeder
each	ADV	je, stück: pro stück
dastardly	A	ruchlos
washtub	N	zuber
racoon	N	waschbär
demonic	A	dämonisch
bribable	A	bestechlich
fallacy	N	irrige ansicht, irrtum, fehlschluss, trugschluss
schoolbook	N	schulbuch
fertile	A	fruchtbar, ertragreich, reich, nahrhaft, nutzbar, ergiebig, geil, produktiv, schöpferisch
coupon	N	karte, marke, bon, coupon, gutschein, kupon, talon, zettel
actuate	V	antreiben, betätigen, gang: in gang bringen
harness	V	anschirren, aufzäumen, bändigen, anspannen, einspannen, ausnutzen, ausnützen, nutzbar machen
harness	N	geschirr, gurtwerk, laufgurt, kabelbaum
skillet	N	bratpfanne
swede	N	schwede, schwedin
paraphernalia	N	zubehör, utensilien, siebensachen, schnickschnack, brimborium, drum und dran
distracted	A	zerstreut, zerfahren, unaufmerksam, beunruhigt, besorgt
spicy	A	würzig, gepfeffert, gesalzen, pikant
omasum	N	blättermagen
fanatic	A	fanatisch
fanatic	N	fanatiker, eiferer
hacienda	N	hazienda
motherly	A	mütterlich
shroud	V	hüllen: in ein leichentuch hüllen, hüllen
shroud	N	leichentuch, schleier, want
spice	V	würzen
spice	N	gewürz, spezerei, würze, anflug, hauch
prototype	N	prototyp, urtyp, urform, urbild
annihilate	V	auslöschen, vernichten, zerschlagen
arranger	N	bearbeiter, arrangeur
eschew	V	scheuen, vermeiden, weg: aus dem wege gehen
grouch	V	brummen, schimpfen, verdrießlich sein
grouch	N	muffel, griesgram, miesepeter
powerless	A	machtlos, kraftlos, ohnmächtig, hilflos
dawdling	N	bummelei
sanies	N	jauche [med.]
self-importance	N	selbstbewusstsein
censor	V	zensieren
censor	N	zensor
devitalize	V	entkräften
planetarium	N	planetarium
casualty	N	opfer, verletzte, gefallene, tote, verunglückte, verwundete, todesopfer, unfallopfer
again	ADV	wieder, erneut, neuerdings, neuerlich, einmal: noch einmal, nochmals, wiederum, gleich
involucre	N	hülse, hüllkelch
idolatress	N	götzendienerin, götzenanbeterin
euphonious	A	wohlklingend
unthinkingly	ADV	unbedacht, gedankenlos, bedenkenlos, blind
equitably	ADV	gerecht, fair
demobilize	V	demobilisieren, entlassen
lues	N	lues
equitable	A	gerecht, unparteiisch, fair, recht und billig
mishmash	N	mischmasch, kauderwelsch
grudge	V	missgönnen
grudge	N	groll, widerwille
bibliographer	N	bibliograph
appareled	A	gewandet
gutless	A	feige
excretion	N	ausscheidung, exkretion, exkret
burrow	V	graben, buddeln, wühlen
burrow	N	bau, höhle
nitwit	N	dummkopf, schwachkopf
cogged	A	gezähnt
founder	V	sinken, untergehen, versinken, straucheln, stolpern, scheitern, fehlschlagen
founder	N	gründer, begründer, stifter, gießer
automatism	N	automatismus, automatie
allergy	N	allergie
commute	V	pendeln, umwandeln, verwandeln
plodding	A	arbeitsam, stapfend
palimony	N	unterhaltszahlung
niacin	N	nikotinsäure, niacin
responsiveness	N	empfänglichkeit
preserves	N	eingemachte
preserver	N	retter
gp	N	arzt: praktischer arzt
musketry	N	musketen, musketiere
preserved	A	konserviert
crimson	A	karmesin, karmesinrot, purpurn, purpurrot
crimson	N	purpur, karmesin
bestir	V	rühren: sich rühren, regen: sich regen
vinegary	A	essig: wie essig
unabashed	A	furchtlos, dreist, unerschrocken, unverfroren, unbeeindruckt
sitting	A	sitzend, brütend, tagend, sitzung: in sitzung
sitting	N	sitzung, tagung, versammlung
puffy	A	aufgedunsen, geschwollen, angeschwollen, gedunsen, verschwollen, aufgequollen, verquollen
plausibility	N	plausibilität, glaubwürdigkeit, glaubhaftigkeit, wahrscheinlichkeit
halftone	N	halbton
clench	V	aufeinanderbeißen, ballen, krampfen, ballen: sich ballen, zusammenbeißen, packen
elated	A	beschwingt, begeistert, freudig erregt, gehoben
washing	N	waschen, wäsche
arts	A	geisteswissenschaftlich
arts	N	geisteswissenschaften
subsoil	N	untergrund
zygote	N	zygote
reciprocation	N	erwiderung, revanche, hin und her [techn.], auf und ab
alms	N	almosen
enrapture	V	entzücken, verzücken, berauschen, hinreißen
tribal	A	stammes-
westerner	N	wessi, westler, abendländer, weststaatler
vacillating	A	schwankend, unschlüssig, unentschlossen
outwork	V	übertreffen: im arbeiten übertreffen
outwork	N	heimarbeit, außenwerk
zero	NUM	null
zero	N	null, nullpunkt, zero, gefrierpunkt
recency	N	neuheit
affable	A	freundlich, leutselig, umgänglich
residue	N	rest, restmenge, rückstand, residuum, reinnachlass
swampy	A	sumpfig
wrecked	A	zerstört
associate	A	außerordentlich
associate	N	kollege, kompagnon, partner
caffeine	N	koffein
trinket	N	schmuckstück: wertloses schmuckstück
wrecker	N	strandräuber, plünderer gestrandeter schiffe, bergungsarbeiter, bergungsschiff, schrotthändler, abbrucharbeiter, abschleppwagen
hotbed	N	brutstätte, nährboden für, tummelplatz
mock-up	N	modell
basely	ADV	gemein, niederträchtig, niedrig
indistinctly	ADV	unklar, undeutlich, unartikuliert
asphyxiation	N	erstickung
mule	N	maultier, selfaktor, maulesel, schlappen, pantoffel
oldie	N	witz: alter witz, oldie, platte: alte platte
salesmanship	N	verkaufstechnik
affectionately	ADV	liebevoll, zärtlich
bushwhacker	N	bandit, guerillakämpfer
monetize	V	münzen prägen
stupor	N	benommenheit, stupor
steerage	N	zwischendeck
lasagne	N	lasagne
lasagna	N	lasagne
uncharted	A	unerforscht, unergründet, verzeichnen: nicht verzeichnet, einzeichnen: nicht eingezeichnet, landkarte: auf keiner landkarte verzeichnet
misery	N	kummer, trauer, trostlosigkeit, trübseligkeit, griesgram, qualen, jammer, misere, elend, erbärmlichkeit, miesepeter
parenthetical	A	parenthetisch
specialize	V	spezialisieren: sich spezialisieren, spezialisiert sein
aria	N	arie
caravan	N	wohnwagen, wagen, karawane, wohnanhänger
arsonist	N	brandstifter
dachshund	N	dachshund, dackel, teckel
archangel	N	erzengel
uniformity	N	einheitlichkeit, gleichheit, gleichmäßigkeit, gleichförmigkeit, eintönigkeit, gleichartigkeit, uniformität, einförmigkeit
electrostatics	N	elektrostatik
plastered	A	voll, besoffen, blau
anathema	N	anathema, kirchenbann
impressionable	A	leicht zu beeindrucken, empfänglich: für eindrücke empfänglich, beeinflussbar
tacky	A	klebrig, schäbig, billig, ordinär
plasterer	N	gipser, stukkateur
blunderbuss	N	donnerbüchse
tenderize	V	weich machen, zart machen, klopfen
caboose	N	kombüse, dienstwagen
handsomely	ADV	elegant, gut, großzügig, anständig
sylph	N	nymphe, sylphe
landed	A	begütert
grisly	A	grausig, grauenerregend, grässlich, schauerlich
misogamy	N	misogamie
disfavor	N	ungnade, ungunst, missfallen
resemblance	N	ähnlichkeit, reminiszenz
barroom	N	schankstube
sulkily	ADV	schmollend, eingeschnappt, beleidigt
dazed	A	bedeppert, benommen, benebelt, betäubt, stutzig, verwirrt
specialized	A	spezialisiert, fachbezogen
stubborn	A	stur, störrisch, starrköpfig, starrsinnig, verbohrt, widerspenstig, eigensinnig, halsstarrig, hartnäckig, verstockt, bockig, dickköpfig
synchronized	A	zeitgleich
petrology	N	gesteinskunde, petrologie
onslaught	N	angriff: heftiger angriff, angriff, attacke, ansturm
tip-top	A	tipptopp, erstklassig, spitzen-, top-
cation	N	kation
collision	N	zusammenstoß, zusammenprall, karambolage, kollision, prall, auffahrunfall, konflikt
junket	V	vergnügungsreise: eine vergnügungsreise machen, feiern
junket	N	dickmilch: süße dickmilch, dickmilch, vergnügungsreise, gelage, fest, lustbarkeit
biography	N	biographie
homicide	N	totschlag, mord, mordkomission, mörder, totschläger
freckle	N	sommersprosse
needs	ADV	unbedingt
needy	A	ärmlich, bedürftig, notleidend
needy	N	bedürftige
demolition	N	demolierung, abbruch, abriss
rapport	N	beziehung, verhältnis, rapport
venting	N	entladung
piebald	A	scheckig
piebald	N	schecke
slackening	N	lockern, lockerung, entspannung, abnahme
redwood	N	redwood
prudence	N	vorsichtigkeit, vorsicht, umsicht, klugheit
dermatology	N	dermatologie
hankie	N	taschentuch
questioning	A	fragend
questioning	N	verhör, vernehmung, befragung, anzweiflung
malediction	N	fluch, verwünschung
fast-growing	A	schnellwüchsig
coming	A	kommend
coming	N	kommen
upholsterer	N	polsterer, sattler, tapezierer
dragon	N	drache, drachen, lindwurm
mislead	V	irreführen, verleiten, irre: in die irre leiten, richtung: in falsche richtung leiten
skilful	A	geschickt, gewandt, kunstvoll
pitch-dark	A	stockdunkel, stockfinster
serenade	N	serenade, ständchen
boisterousness	N	ausgelassenheit
perpetually	ADV	ständig
heartfelt	A	herzlich, innig
through	A	durchdringend, durchgehend, bisgehend, fertig
through	ADV	durch
hundredth	A	hundertste
hundredth	N	hundertstel
fissure	N	riss, spalt, spalte, fissur
bosom	A	busen-
bosom	N	busen
baal	N	baal
impressiveness	N	stattlichkeit
procuress	N	kupplerin, kuppelmutter
toothy	V	pferdegebiss: mit einem pferdegebiss
homicidal	A	gemeingefährlich, mörderisch, mord-
socially	ADV	gesellschaftlich, sozial, privat
tinned	A	dosen-, büchsen-, konserviert, verzinnt
frigid	A	kalt, kühl, frostig, eisig, förmlich, frigide
compound	A	kompliziert, zusammengesetzt
compound	N	verbindung, kompositum, wort: zusammengesetztes wort, zusammensetzung, hundezwinger, gehege, lager, gefängnishof
prejudiced	A	voreingenommen, vorgefasst, befangen
viewers	N	zuschauer
huddle	V	drücken: sich drücken, zusammendrängen: sich zusammendrängen, drücken
huddle	N	haufen, gruppe
evade	V	ausweichen, entziehen: sich entziehen, entkommen, vermeiden, umgehen
micro	N	mikrocomputer
namibia	N	namibia
sackful	N	sackvoll, sack
politicize	V	politisieren
disentanglement	N	entwirrung
winnow	V	sichten, worfeln
engaging	A	einnehmend, gewinnend
engaging	N	verpflichtung
excrescence	N	auswuchs
edged	A	kantig
acquisitive	A	habgierig
respectful	A	achtungsvoll, ehrerbietig, treu, gemessen, respektvoll
perry	N	most, birnenmost
louver	N	jalousie, lattenfenster
caloric	A	kalorisch, wärme-
deft	A	flink, geschickt, gewandt
granulated	A	gekörnt, granuliert, körnig
henceforward	ADV	von nun an, fortab, fortan, hinfort, künftig
airframe	N	zelle, flugwerk
cockroach	N	kakerlake, küchenschabe, schäbe, kakerlak
bombshell	N	bombe, knalleffekt, überraschung: plötzliche überraschung
centerfold	N	mittelfaltblatt
beginning	N	anfang, beginn, anbruch, ansatz, antritt, ausgang, eingang, ursprung
faucet	N	wasserleitung, wasserhahn
simonize	V	polieren
congealment	N	erstarrung
wither	V	austrocknen, schwinden: zum schwinden bringen, verdorren, ausdörren, verkümmern, vertrocknen, welken, dahinschwinden
sarcasm	N	sarkasmus
wired	A	verdrahtet, draht: mit draht versteift
mazurka	N	mazurka
wallboard	N	sperrholz
ruination	N	zerstörung, ruinierung, verderben, grab
indebted	A	verpflichtet, verschuldet
licorice	N	lakritze, süßholzwurzel, lakritz, süßholz
valentine	N	valentinskarte
nurseryman	N	gärtnereiarbeiter, gärtner, gärtnereibesitzer
dilute	A	verdünnt
dilute	V	verdünnen, dämpfen, auffüllen, strecken, verwässern
scandalously	ADV	skandalös, empörend
chipboard	N	spanholzplatte
jabber	V	schwatzen, daherplappern, plappern, quasseln, herunterrasseln, abhaspeln, schwätzen, labern
jabber	N	geplapper, geschnatter, gequassel
unacquainted	A	vertraut: nicht vertraut, unerfahren
razor	N	rasierapparat, rasiermesser, messer, apparat
cirque	N	zirkus
jetty	N	mole, hafendamm, anlegebrücke, landungsbrücke, anlegesteg, landesteg, pier
ordure	N	kot, unrat, unflat, schmutz
catapult	V	katapultieren, schleudern, schleudern: geschleudert werden, katapultieren: katapultiert werden
catapult	N	schleuder, katapult
scantily	ADV	spärlich
differentiate	V	ableiten, differenzieren, trennen, unterscheiden
prodigious	A	ungeheuer, außerordentlich, erstaunlich, gewaltig, wunderbar, großartig
unpardonable	A	unverzeihlich
conventionality	N	gebräuchlichkeit, konventionalität, konventiongebundenheit, herkömmlichkeit, art: traditionelle art
commiserate	V	mitfühlen
ogress	N	riesin: menschenfressende riesin, ungeheuer, unmensch
cyclic	A	zyklisch
unbroken	A	unbeschädigt, heil, unverletzt, zerbrochen: nicht zerbrochen, unzerbrochen, erbrochen: nicht erbrochen, gebrochen: nicht gebrochen, ungepflügt, ununterbrochen, ungebrochen, geschlossen, nicht durchbrochen, direkt, unüberboten, ganz, zureiten: nicht zugeritten, ungebeugt
bawl	V	brüllen, schreien, grölen, plärren, heulen
anthropoid	A	anthropoid, menschenähnlich
anthropoid	N	menschenaffe, anthropoid
swerve	V	bogen: einen bogen machen, ausweichen, schlenkern, ausbrechen
swerve	N	bogen, schwenkung, schlenker, effet
bassinet	N	korbwiege, korbwagen, babykorb
lilting	A	singend, beschwingt, munter
confessional	N	beichtstuhl
left-handed	A	linkshändig, linkshänder: für linkshänder, zweifelhaft
direct	A	direkt, gerade, geradlinig, durchgehend, unmittelbar, glatt, offen, spezifisch, wörtlich
direct	V	richten, leiten, führen, lenken, anleiten, anordnen, dirigieren, adressieren, anweisen, inszenieren
clotting	N	gerinnung
hangout	N	stammlokal
overdraw	V	überzeichnen, überziehen, übermalen
showery	A	regnerisch
blanch	V	blanchieren, blass werden, erbleichen, abbrühen, brühen, erblassen
oracular	A	orakelhaft, seherisch, weise
refute	V	entkräften, widerlegen
couch	V	formulieren, abfassen, einkleiden, kleiden, anlegen, lauern, lauer: auf der lauer liegen, einlegen
couch	N	couch, sofa, liege, kanapee, lager
recondite	A	abstrus
unscheduled	A	geplant: nicht geplant, außerfahrplanmäßig, außerplanmäßig, programmmäßig: nicht programmmäßig
chary	A	vorsichtig, zurückhaltend
serene	A	gelassen, gleichmütig, ruhig, heiter
godfather	N	pate, patenonkel
breadwinner	N	brotverdiener, ernährer, unterhalter, versorger
disconcerted	A	beunruhigt, befremdet
unceremoniously	ADV	umschweife: ohne umschweife, federlesen: ohne viel federlesen, zwanglos, formlos
charm	V	bezaubern, beschwören, bestricken, berücken
charm	N	anmut, charme, liebreiz, reiz, bann, zauberformel, talisman, zauber, amulett, anhängsel
off-key	A	falsch
chard	N	mangold
aileron	N	querruder
feasting	N	schlemmerei, schwelgerei
unsealed	A	offen, unverschlossen, unversiegelt
dystrophy	N	distrophie
panegyric	N	lobesrede, lobrede, panegyrikum
suppleness	N	geschmeidigkeit, elastizität, weichheit, biegsamkeit, beweglichkeit
mammoth	A	riesig, kolossal, mammut-, ungeheuer
mammoth	N	mammut
ruggedness	N	rauheit, wildheit, zerklüftetheit, felsigkeit, grobheit, markigkeit, verbissenheit, urtümlichkeit, urwüchsigkeit
clinician	N	kliniker
swelling	A	schwellend
swelling	N	schwellung, anschwellung, verdickung, anwachsen, blähen, anschwellen, quellen
passer-by	N	passant, vorübergehende
converge	V	zusammenlaufen, sammeln: sich sammeln, konvergieren, zusammenströmen, annähern: sich einander annähern
soignee	A	soigniert
immaturity	N	unreife
chock	N	keil, bremskeil, bremsklotz, lippe, lippklampe
brooklet	N	bächlein
washed-up	A	ausgebufft
merger	N	fusion, verschmelzung, zusammenschluss
lather	V	schäumen, einschäumen
lather	N	schaum, seifenschaum, schweiß
headman	N	häuptling, stammesoberhaupt
intractable	A	widerspenstig, unnachgiebig, hartnäckig, unlenksam
cholera	N	cholera
express	A	ausdrücklich, bestimmt
express	ADV	express, per express
latticed	A	vergittert
breast	N	brust, bruststück, busen
irresolution	N	unentschlossenheit, unentschiedenheit, unschlüssigkeit
autobiographic	A	autobiographisch
scorbutic	A	skorbutisch
spiked	A	spikes: mit spikes, schuss: mit schuss
emolument	N	vergütung
logistic	A	logistisch
doubler	N	doppler
doubles	N	doppel
mouthwash	N	mundwasser
doublet	N	dublette
biannual	A	zweimal jährlich, halbjährlich
manly	A	männlich, mannhaft
snow-capped	A	schneebedeckt
lisbon	N	lissabon
quiche	N	quiche
pennon	N	wimpel
marinate	V	marinieren, beizen
debar	V	hindern, verbieten, verhindern
equivocate	V	zweideutig reden, ausweichen, ausweichend antworten
shatterproof	A	splitterfest, splitterfrei
vascular	A	vaskulär
internationalism	N	internationalismus
subscript	A	daruntergeschrieben
subscript	N	daruntergeschriebene, tiefsatz, indexliste, index
encephalitis	N	gehirnentzündung
transmutable	A	verwandelbar
beetling	A	überhängend
figurehead	N	galionsfigur
trustingly	ADV	treu
mailbox	N	briefkasten, postkasten
premise	N	prämisse, voraussetzung
inimitable	A	unnachahmlich
acidulous	A	säuerlich, mürrisch, verdrießlich, unzufrieden, verärgert
glorification	N	verherrlichung, seligpreisung, lobpreisung
symbolical	A	symbolhaft, symbolisch, sinnbildlich
defunct	A	stillgelegt, verstorben, eingegangen, untergegangen, kraft: außer kraft
rasher	N	scheibe, speckscheibe, streifen
quarrelsome	A	streitsüchtig, zänkisch, händelsüchtig, unverträglich
quadruped	N	vierfüßer, vierfüßler
sparring	N	sparring, sparringkampf
suede	A	wildleder-, wildledern
suede	N	wildleder, veloursleder, velour, leder
entrenchment	N	verschanzung, schanze, schanzwerk
baltimore	N	baltimore
floozy	N	schickse
esprit	N	esprit
massiveness	N	ausmaß: riesige ausmaße, ausmaß: gewaltige ausmaße, größe: enorme größe, wuchtigkeit, massivität, gewaltigkeit
point	V	richten, zeigen, anspitzen, spitzen, verfugen, ausfugen, interpunktieren, vokalisieren, anzeigen, weisen, hinweisen, hindeuten, liegen, gerichtet sein, vorstehen, stehen
point	N	punkt, auge, vokalzeichen, strich, grad, spitze, zacke, zipfel, ecke, landspitze, zacken, pointe, ende, stelle, zweck, ziel, sinn, unterbrecherkontakte, anschluss, steckdose
pamphlet	N	broschüre, druckschrift, flugschrift, flugblatt, prospekt, pamphlet, abhandlung
tennessee	N	tennessee
breastwork	N	brustwehr
civilize	V	zivilisieren, kultur beibringen
weaving	N	weberei
fructify	V	befruchten, früchte tragen
apostle	N	apostel
appall	V	entsetzen
confirmatory	A	bestätigend
peppery	A	gepfeffert, pfefferig, jähzornig
omniscient	A	allwissend
hag-ridden	A	vergrämt, verhärmt
assorted	A	ausgewählt, gemischt
ineptitude	N	ungeschicktheit, unbeholfenheit, unangebrachtheit, plumpheit, ungeeignetheit, ungeschick, ungelehrigkeit, begriffsstutzigkeit
decorous	A	anständig, schicklich
dissension	N	uneinigkeit
undercharge	V	berechnen: zu wenig berechnen
patriarchy	N	patriarchat, vaterrecht
evangelical	A	evangelisch
quotability	N	zitierbarkeit
grainy	A	körnig, gekörnt, genarbt, maserig, gemasert
horseshoe	N	hufeisen
tiered	A	gestuft
skiff	N	skiff
teaspoonful	N	teelöffel
unearned	A	unverdient
portugal	N	portugal
perilously	ADV	gefährlich
faceted	A	facettiert
gobble	V	schlingen, verschlingen, schmatzen, kollern
hydrocele	N	wasserbruch
breastbone	N	brustbein, brustknochen
anode	N	anode
bookkeeper	N	buchhalter
disbelieving	A	ungläubig
urethra	N	harnröhre, urethra
migraine	N	migräne
perpetrator	N	täter, verbrecher
bristly	A	borstig, stachelig, stoppelig, stoppel-
preferentially	ADV	bevorzugt
wavy-grained	A	geflammt
counterfeiter	N	falschmünzer, fälscher
bristle	V	sträuben: sich sträuben, zu berge stehen
bristle	N	borste, stoppel
subcutaneous	A	subkutan
quick-frozen	A	gefrier-, tiefgekühlt
windmill	N	windmühle
prig	N	mensch: selbstgefälliger mensch, tugendlamm, musterknabe, schnösel
puritanical	A	puritanisch
ardour	N	leidenschaft, begeisterung, eifer, heftigkeit, feuer, glut, inbrunst
fustian	A	schwülstig, barchent-
fustian	N	schwulst, barchent
unveil	V	enthüllen, weihen, vorstellen, entschleiern, sichtbar werden lassen, entschleiern: sich entschleiern, fallen lassen: den schleier fallen lassen
horse-drawn	A	pferd: von pferden gezogen
lacrosse	N	lacrosse
organically	ADV	organisch, biodynamisch
task	N	aufgabe, pflicht, auftrag, amt, pensum
panelling	N	täfelung, paneel, wandverkleidung, wandbekleidung, verschalung, verkleidung
iffy	A	strittig, fraglich, zweifelhaft
nordic	A	nordisch
jacobite	N	jakobit
irritably	ADV	gereizt
pyrometer	N	pyrometer
zestfully	ADV	schwungvoll
segregate	V	absondern, geschlecht: nach geschlecht trennen, rasse: nach rasse trennen, segregieren, trennen
scrofulous	A	skrofulös, verkommen
shrewdly	ADV	geschickt, clever, schlauerweise
world	N	welt, erde
snare	V	einfangen
snare	N	falle, schlinge, sprenkel
overfed	A	überfüttert
cut	V	abschneiden, abstechen, anschneiden, beschneiden, kappen, mähen, schneiden, stechen, verschneiden, zerschneiden, graben, hauen, schleifen, brechen, schwänzen, herabsetzen, kupieren, kürzen, reduzieren, senken, verkürzen, streichen, überblenden
cut	N	schnitt, schnittstelle, schnittwunde, einschnitt, schmarre, zuschnitt, kürzung, streichung, verminderung, schliff, anteil, abkürzung, unterbrechung
cur	N	köter, schuft
emigre	N	emigrant
coal-black	A	kohlenschwarz
cue	V	stichwort: das stichwort geben, abfahren lassen, geben: den einsatz geben
cue	N	stock, stichwort, queue
cud	N	futter: wiedergekäutes futter
undistinguished	A	mittelmäßig, mäßig, unbekannt, durchschnittlich, undeutlich, unterscheiden: nicht unterschieden
cub	N	welpe, junge
babylonian	A	babylonisch
babylonian	N	babylonier
dependability	N	zuverlässigkeit, verlässlichkeit
suffocation	N	erstickung
zoroaster	N	zoroaster, zarathustra
semolina	N	grieß, grießbrei, grießmehl
irretrievable	A	unwiederbringlich, wiederbekommen: nicht mehr wiederzubekommend, unersetzlich
retake	V	wiedereinnehmen, wiederholen, zurückerobern
retake	N	neuaufnahme, wiederholung
temperamentally	ADV	temperamentvoll, launenhaft, launisch, veranlagungsmäßig, angeboren
purveyor	N	verkäufer, lieferant
forcefulness	N	überzeugungskraft
loyalist	N	regierungstreue
walrus	N	walross
irretrievably	ADV	unwiederbringlich
unhindered	A	unbehindert, behindert: nicht behindert, ungehindert, hindern: nicht gehindert, ungestört
diocese	N	diözese, sprengel, bistum, stift
absolutely	ADV	absolut, eindeutig, vollkommen, völlig, streng, unbedingt, rein, reineweg, grundsätzlich, durchaus
cicada	N	zikade, zirpe
candle	N	kerze, licht
minefield	N	minenfeld
culprit	N	missetäter, täter, schuldige, übeltäter
proficient	A	tüchtig, fähig, erfahren, geübt
balmy	A	balsamisch, lau, lind, mild, wohlriechend
precook	V	vorkochen
epic	A	episch, monumental, gewaltig
epic	N	epos, heldengedicht, film: monumentaler film, roman: monumentaler roman, spiel: gewaltiges spiel
inimical	A	feindlich
pondweed	N	laichkrautgewächs
well-ordered	A	geordnet, wohlgeordnet, geregelt, regelmäßig
eglantine	N	weinrose
skinniness	N	magerkeit
feigning	N	verstellung
inhumanity	N	unmenschlichkeit
mrs.	ABBR	frau
intestinal	A	darm-
canvassing	N	stimmenwerbung, wahlwerbung, von-haus-zu-haus-gehen, klinkenputzern, meinungsforschung
acquirement	N	aneignung
connubial	A	ehelich, ehe-
depose	V	absetzen, entthronen, stürzen
tiff	N	krach
abusive	A	beleidigend, ausfällig, ausfallend, beschimpfend, missbrauch treibend
retailer	N	einzelhändler, kleinhändler, wiederverkäufer
inhospitable	A	ungastlich, gastfreundlich: nicht gastfreundlich, unwirtlich
obscenely	ADV	ekelerregend
liege	N	lüttich
pleating	N	plissee
normality	N	normalität
zealotry	N	fanatismus, eifer: blinder eifer
exiguous	A	klein, winzig, gering, dürftig
wattle	N	reisigmatte
invite	V	einladen, laden, bitten, führen zu, auffordern, herausfordern
motivational	A	motivational
patronizingly	ADV	gönnerhaft, herablassend
mechanistic	A	mechanistisch
switchboard	N	vermittlung, zentrale, telefonzentrale, schalttafel, schaltbrett
subsidiary	A	untergeordnet, neben-, tochter-
subsidiary	N	tochtergesellschaft, tochter, zweigniederlassung, nebenfach, ableger
couchant	A	liegend
casein	N	kasein
fissile	A	spaltbar
natality	N	geburtenziffer
repulse	V	zurückschlagen, abwehren, abschlagen, zurücktreiben, zurückwerfen, abweisen, zurückweisen, abstoßen, vertreiben
repulse	N	abwehr, zurückschlagen, abweisung, zurückweisung
curt	A	angebunden, brüsk, rüde, schroff, unverbindlich, barsch
inexpertly	ADV	unfachmännisch, laienhaft, unsachgemäß, ungeübt
discreetness	N	schweigsamkeit, unaufdringlichkeit, diskretheit
deprive	V	absetzen, ausschließen, berauben, entziehen, vorenthalten
scarlet	A	scharlachrot, knallrot, hochrot, puterrot
scarlet	N	scharlach, scharlachrot
curd	V	gerinnen lassen, gerinnen
curd	N	quark
cure	V	heilen, kurieren, helfen, abhelfen, haltbar machen, räuchern, trocknen, pökeln, entwöhnen
cure	N	heilung, kur, abhilfe, heilmittel, rezept
curb	V	zügeln, beherrschen, bezähmen, mäßigen, dämmen, beeinträchtigen, verhalten, einengen
curb	N	behinderung, beschränkung, bordkante
appetizing	A	appetitanregend, appetitlich, einladend, lecker, mündig, schmackhaft, verlockend
organizational	A	organisatorisch
serological	A	serologisch
curl	V	locken, kringeln, ringeln, kräuseln: sich kräuseln, locken: sich locken
curl	N	locke, kringel, rotation
cafe	N	imbissstube, cafe, kneipe, konditorei, restaurant: kleines restaurant
yearbook	N	jahrbuch
overfeed	V	überfüttern, überernähren, nudeln
stripper	N	stripper, stripperin, abbeizmittel
adoring	A	bewundernd
currycomb	V	striegeln
currycomb	N	striegel
mayonnaise	N	mayonnaise
ungrammatically	ADV	ungrammatisch
underweight	A	untergewichtig
underweight	N	untergewicht
unshielded	A	schutzlos
intensifier	N	verstärkungspartikel, verstärker
endocrine	A	endokrin
pineapple	N	ananas
overladen	A	überladen
cater	V	lebensmittel liefern, sorgen, vorsehen
utterly	ADV	total, völlig, zutiefst, ganz, äußerst, durch und durch
unenforceable	A	durchsetzbar: nicht durchsetzbar, undurchführbar
worsted	N	kammgarnstoff, kammgarn
scouting	N	erkunden, auskundschaften, ausklärung, suche, talentsuche, pfadfinderei, pfadfindertum
deterrence	N	abschreckung
overlooking	A	zugewandt
cooker	N	herd, kocher, kochapfel
irradiate	V	ausstrahlen, einstrahlen, erhellen, bestrahlen
cavity	N	höhle, röhre, hohlraum, loch, höhlung
ignoramus	N	nichtswisser, nichtswisserin, ignorant, analphabet
razing	N	schleifung
uterus	N	gebärmutter, uterus
conjugal	A	ehelich, ehe-
mix-up	N	durcheinander, vertauschung, verwechslung, verwirrung, schlamassel
ready-made	A	fertig
caribou	N	karibu
whiting	N	merlan
amplifier	N	verstärker
wrangle	V	streiten, rangeln, feilschen, zanken: sich zanken
wrangle	N	gerangel, hin und her, streit, zank
autism	N	autismus
snowmobile	N	schneemobil
strew	V	verstreuen, streuen, übersäen
objurgation	N	tadel, rüge
vietnamese	A	vietnamesisch
vietnamese	N	vietnamesin, vietnamese, vietnamesisch
franciscan	A	franziskaner-
franciscan	N	franziskaner
welter	V	rollen, wälzen: sich wälzen
welter	N	chaos, meer, sturm, tumult, unzahl
saga	N	saga, sage, generationsroman, geschichte, story
compost	N	kompost
masculine	A	männlich, maskulin, stumpf
pleasing	A	angenehm, gefällig
nervousness	N	nervosität, aufgeregtheit, bange, ängstlichkeit
proctor	N	prokurator, proktor, prüfungsaufsicht, aufsicht
presently	ADV	gegenwärtig, bald, jetzt, augenblicklich
unhurt	A	unverletzt, unbeschädigt, heil
dessert	N	speise, nachtisch, dessert
implicitly	ADV	implizit, indirekt, unausgesprochen, unbedingt
opportuneness	N	opportunität
entire	A	ganz, vollständig, gesamt, heil
verandah	N	veranda
absinthe	N	absinth
communicant	N	kommunikant
sallowness	N	blässe, fahlheit
peddle	V	kolportieren, feilbieten, hausieren, verkaufen, verbreiten
append	V	befestigen, hinzufügen
splashdown	N	wasserung
dowdy	A	unschick
bail	N	kaution, sicherheitsleistung, querholz, trennstange
calorific	A	wärmeerzeugend
pleading	A	bittend, flehend, flehentlich
pleading	N	bitten, plädoyer
embroilment	N	verwicklung
apologetic	A	bedauernd, entschuldigend
packing	N	packen, verpacken, verpackung, abpackung, versatz, abdichtung, dichtung, füllsel
licentiousness	N	unmoral, unzüchtigkeit, freizügigkeit, lüsternheit
healing	A	heilend, heilsam
healing	N	heilung, vernarbung, heilen
abbacy	N	klostervorsteher
self-winding	A	automatik-
principally	ADV	hauptsächlich, linie: in erster linie, vornehmlich
anthropological	A	anthropologisch
honor	V	ehren, verehren, honorieren, beehren, auszeichnen, respektieren, annehmen, einlösen, begleichen, nachkommen, stehen zu, anerkennen
honor	N	ehre, würde, ehrung, würdigung, auszeichnung
accusative	N	akkusativ
faultiness	N	mangelhaftigkeit, schadhaftigkeit
decentralized	A	dezentral
bushman	N	buschmann
gangsaw	N	gattersäge
composer	N	komponist
thailand	N	thailand
superordinate	A	übergeordnet
limpness	N	schlaffheit, erschlaffung, schlappheit, welkheit, weichheit, mattigkeit, kraftlosigkeit, süßlichkeit
belittling	N	herabsetzung, herabwürdigung, verkleinerung
readable	A	lesbar, ablesbar, lesenswert
cretaceous	A	kreidehaltig, kreide-, kretazeisch
totality	N	gesamtheit, totalität, vollständigkeit
butler	N	butler
phallus	N	phallus
charcoal	N	holzkohle, kohle, zeichenkohle
engender	V	erzeugen
kiosk	N	bude, kiosk
basalt	N	basalt
habitually	ADV	ständig
dentistry	N	zahnheilkunde
fooling	N	betrug, dummheiten
gruff	A	schroff, rauh, unwirsch, knorrig, ruppig
closing	A	schließend, schluss-
closing	N	aufhebung, löschung, schließung, sperrung, schluss, schließen
rehabilitation	N	rehabilitation, reaktivierung, sanierung
panderer	N	kupplerin, kuppler
experiential	A	erfahrung: auf erfahrung beruhend, erfahrungs-
steeplejack	N	klettermax
syrupy	A	dickflüssig, sirupartig
antedate	V	vorausdatieren, vordatieren
exorbitantly	ADV	maßlos, exorbitant
onomatopoetic	A	onomatopoetisch, schallnachahmend
commutable	A	umwandelbar
varied	A	unterschiedlich, abwechslungsreich, bewegt, reichhaltig, vielfältig, mannigfaltig, vielseitig, verschiedenartig, bunt, buntgemischt, kunterbunt
voracity	N	gefräßigkeit
stone-dead	A	mausetot
hampshire	N	hampshire
confidant	N	vertrauensperson, konfident, vertraute
profile	N	profil, profilbild, umriss, seitenansicht, porträt, querschnitt, längsschnitt, kurzbiographie
spin-dry	V	schleudern
incompetence	N	unfähigkeit, untauglichkeit, unzuständigkeit, inkompetenz
carbuncle	N	karbunkel
leukemia	N	leukämie
quisling	N	kollaborateur, quisling
prostate	N	prostata, vorsteherdrüse
pleasantness	N	freundlichkeit, erfreulichkeit, heiterkeit, gefälligkeit, gemütlichkeit, angenehme
lecher	N	lüstling, wollüstling, wüstling, lustmolch
guilder	N	gulden
non-finite	A	infinit
platypus	N	schnabeltier
congruent	A	kongruent
